ire : Colère
esse : Crochet en forme de S
ergoter : Trouver à redire sur des points de détail, des choses insignifiantes
blezimarder : Se couper mutuallement la réplique, empêcher le dialogue
sybarite : Se dit d'une personne qui recherche les plaisirs de la vie dans une atmosphère de luxe et de raffinement
quidam : Un certain individu, une personne
altermoiement : Action de différer, de remettre à un autre temps
borborygmes : Bruit produit par le déplacement des gaz dans l'intestin ou l'estomac
aphasi : Perte totale ou partielle de la capacité de parler ou de comprendre le langage parlé ou écrit, due à une lésion cérébrale
kyrielle : Longue suite (de paroles) interminable
andain : Rangée régulière d'herbe fauchée
parangon : Modèle
expier : Réparer, en être puni (par une conséquence pénible ou un sentiment de culpabilité)
proroger : Renvoyer à une date ultérieure
pis-aller : Personne, solution, moyen à quoi on a recours faute de mieux
embauchoir : Instrument que l'on place dans les chaussures pour en conserver la forme et éviter les plis du cuir
acrimonie : Mauvaise humeur qui s'exprime par des propos acerbes ou hargneux
fragrence : Parfum subtil, odeur agréable
hapax : Mot, forme, emploi dont on ne peut relever qu'un exemple
absoudre : Exempter de peine l'auteur d'une infraction
adjuvent : Médicament, produit ajouté à un autre pour renforcer ou compléter son action
syncretisme : Combinaison de doctrines, de systèmes initialement incompatibles
tessiture : Étendue des sons qui peuvent être émis normalement par une voix, un instrument
alluvion : Dépôts (cailloux, sables, boues) provenant d'un transport par les eaux courantes
saynete : Courte pièce comique avec peu de personnages
timorer : Qui est trop méfiant, trop attaché à ses habitudes, qui craint le risque, les responsabilités, l'imprévu
anaher :Faire entendre des ahans
pileus : À l'époque hellénistique et romaine, un petit bonnet rond, emboîtant bien le crâne
senestre : La main gauche
succin : Ambre jaune
mulet : Hybride mâle de l'âne et de la jument ou du cheval et de l'ânesse , toujours infécond
fat : Qui montre sa prétention de façon déplaisante et un peu ridicule
irmis : Système international d'information sur le contrôle radiologique
circonspet : Qui est attentif et prudent dans ses actes
diacre : Une personne qui assiste le dirigeant d'une église locale chrétienne et a la responsabilité de certaines activités
endémi :  Persistance habituelle d'une maladie infectieuse et contagieuse dans une région donnée
godiche : Benêt, maladroit
gadin : chute
suranné : Qui a cessé d'être en usage, qui évoque une époque révolue
capiteux : Qui monte à la tête, qui produit une certaine ivresse
confusianisme : Courant majeur de la pensée chinoise,qui repose essentiellement sur des préceptes défendant une morale humaniste sans recours à une métaphysique
barbiturique : Représentent un groupe de dépresseurs du système nerveux central qui exercent des effets allant de la sédation légère à l'anesthésie générale
flamine : Prêtre attaché au service d'une divinité
immanence : Opposée à la transcendance, caractérise ce qui est intérieur à un être ou à une pensée
condé : policier
etrusque : peuple qui a vécu dans le centre de la péninsule italienne, notamment sur la côte Tyrrhénienne
as libitum : À volonté, au choix
gager : S'engager à faire quelque chose
aporie : Difficulté logique insoluble
opignatre : Tenace dans ses idées, ses résolutions
indolent : Qui évite de faire des efforts
turpitude : Caractère de bassesse, d'indignité
bakélite : Matière plastique qui imite l'ambre, obtenue en traitant le formol par le phénol
cosmopolite : Qui comprend des personnes de tous les pays, subit des influences de nombreux pays
didgeridoo : Instrument à vent des aborigènes australiens fait d'un long tuyau de bois évidé, à l'embouchure façonnée dans de la cire d'abeille
mausade : Qui n'est ni gai ni aimable
régalien : Qui relève de l'autorité souveraine
patibulaire : Qui semble appartenir à un criminel (visage, apparence)
lingua franca : Langue véhiculaire utilisée sur une aire géographique assez vaste
acerbe : Qui cherche à blesser ; qui critique avec méchanceté
lavasse : Boisson, soupe trop étendue d'eau
goémon : Algues marines
varech : Ensemble des algues, des goémons rejetés par la mer et qu'on récolte sur le rivage
galurin : Chapeau
éphéméride : Liste groupant les évènements qui se sont produits le même jour
farder : Déguiser la véritable nature de (qqch.) sous une apparence trompeuse
comparse : Personnage dont le rôle est secondaire, de peu d'importance
interlope : Dont l'activité n'est pas légale
couffin : Corbeille souple de paille, d'osier servant de berceau
couvin : Ensemble des œufs et des larves d'abeilles et d'autres insectes vivant en société
erg : Région du Sahara couverte de dunes
émolument : Honoraires d'un officier ministériel
zélote : Personne animée d'un zèle fanatique
beffroi : Tour de bois mobile employée au moyen âge dans le siège des villes
lémure : Chez les Romains, Spectre d'un mort revenant tourmenter les vivants
diligence : Rapidité dans l'exécution d'une chose
idiomatique : Spécifique à une langue